150
    =   =    =!  
 + M= @ = -  =   
 X  ==#==    =   
             = X 
 ^           ====
W    K     X     
** X        ^    
T*     ?         
-----------------
2 1 3 15 5 11 6 3