130
  !  W  =   =====
? =  X  =   = - =
#======*=   = X =
  ^         =====
     ^      !    
#======#======#= 
  =   ! +  ==@*= 
  = T = X  ===== 
X *  K=   M=     
-----------------
7 8 1 5 2 14 8 0